1111111111111111111111111111111
111111E000001111111000000111111
1111111111100011100000000001111
111100000000001110000P000001111
1100000000000001000000000000011
1000000000000000000000000000001
1000000000000000000000000000001
1000000000000000000000000000001
10000000C0000000000000000000001
1100000000000000000000000000011
1111000000000000000000000001111
1111000000000000000000000001111
1111110000000001111111111111111
1111111100000000000000011111111
1111111111111111100C00011111111
1111111111000000000001111111111
1111111111110000000111111111111
1111111111110000000111111111111
1111111111111100011111111111111
111111111111111C111111111111111
1111111111111110111111111111111
1111111111111111111111111111111